AN AN AM AR AP AN AN AN
AN AN AN AN AN AN AN AN
a0 GO GN a0 GN GN GN a0
a0 GN GN a0 GN GN GN a0
a0 AN AN AN AN AN AN a0
AN AN AN AN AN AN AN AN
AC AN AN AN AN AN AN AC
a0 AC AC AC AC AC AC a0