AP AP AF AP AO AS AO AR
AO AM AR AF AP AR AO AP
a0 GF GR a0 GF GR GP a0
a0 GR GS a0 GS GP GS a0
a0 AO AO AS AF AO AR a0
AP AO AS AF AP AP AM AP
AC AF AR AP AO AP AP AC
a0 AC AC AC AC AC AC a0